00000000000000000000000000000000000000000000000000
00000000000000000000000000000000000000000000000000
00000000000000000000000000000000000000000500000000
00000000000000000000000000000000000000001110000000
00000000000000000000000000000000000000000000000000
00000000000000000000000000000000000000000000000000
00000000000000000000000000000000001001010000000000
00000000000000000000000000000000000000000000000000
00000000000111222000000000000000000000000000000000
00000000000000000000000000000000000000000000000000
00000000000000000000000000011100000000000000000000
00000000000000000000000000000000000000000000000000
00000000000000000000000000000000000000000000000000
00000000000000000000000000000000000000000000000000
00000000001111100000000000000000000000000000000000
00000000000000000000000000000000000000000000000000
00000000000000000000000000000000000000000000000000
00000000000000000000000000000000000111221000000000
00000000000000000000000000000000000000000000000000
00000000000000000000000000000000000000000000000000
00000000000000000000000000000000000000000000000000
11111111111111000011112211111000001111111111111111
11111111111111000011111111111000001111111111111111
00000000000000000000000000000000000000000000000000
00000000000000000000000000000000000000000000000000
