00000000000000000000000000000000000000000000000000
00000000000000000000000000000000000000000000000000
00000000000000000000000000000000000000000000000000
00000000000000000000000000000000000000000000000000
00000000000011111000000000000000000000000000000000
06000000000000000000000000000000000000000000000000
11100000000000000000000000000000000000000000000000
00000000000000000000000000000000000000000000000000
00000000000000000000000000000000000000000000000000
00000000000000000111110000000000000000000000000000
00000000000000000000000000000000011111000000000000
00000000000000000000000000000000000000000000000000
00000000001111111000000100000000000000000000000000
00000000000000000000000100000000000000000000000000
00000000000000000000000100000000000000000000000000
00000000000000000000000100000000000000000000000000
00000000001111111111111100000000000000000000000000
00000000000000000000000000000000000000000000000000
00000000000000000000000000000000000000000000000000
00000000000000000000000000000000000000000000000000
00000000000000000000000000000000000000000000000000
11110000000000000000000011110000000000000000011111
11110000000000000000000011110000011000000000111111
00000000000000000000000000000000000000000000000000
00000000000000000000000000000000000000000000000000
